%%%%%%%%%%%%%%%%%%%%%%%%%%%%%%%%%%%%%%%%%%%%%%%%%%%%%%%%%%%%%
%     %       %             %         %     %           %   %
%%% %%% %%%%%   %%%%% %%%%% %%% %%%%%%% % %%% %%%%%%%%%%% %%%
%   %   %     %   % %   % %   %         %          % % %    %
% %%% %%% %%% %%% % %%% % %%% % %%%%%% %%%%% %%%%% % % %%%% %
% %   % %   % %   %   % % % % %     %        %   % % %      %
%   %%% % % % % % % % %%% % % % %%% % %%%% % %%% % % %% % % %
% %   %   % %   %   % %   % %     % % %  % %     % %  %%% % %
% %%%%%%% % % %%% %%% %%%   %%% %%% % % %% %%%%% %%%% % % % %
%   %   % %       % % %   % % %  %  % %  %    %     %   % % %
% % %%% % %%%%%%%%% % % %%% % %  % %% %% % %%%%%%%%%%% %%%% %
% %   % %   %       %%% %     %  %    %  %      %           %
% % %%% %%%%% %%%%%   % %%%%%%%% %%% %%% % %% %%% %%%%%%% % %
% %   %       %     %   %        %     % %  %   %     %   % %
% %%%%%%% %%%%% %%%%% % %%%%% %%%%%%%%%% % %%%%%% %%% %%% % %
% % %     %     %   % %             %    %    %   %     % % %
%   %%% %%% %%%%%%% %%%%% %%%%%%% %%% %% %%%  % %%% %%% %%% %
% %   %   %       % %     %            %   %    %     %   % %
% %%%%% % %%%%%%% %%%%%%% %%%%%%%% %%% % %%%%%% % % %%%%% % %
%.%     %   %     %       %   %    %   %        % % %   % % %
%%%%%% %% % % %%%%% %%%%% %%% % %%%% %%%%%%%%%%%%%%%% %%% % %
%P        % %           %     %           %           %     %
%%%%%%%%%%%%%%%%%%%%%%%%%%%%%%%%%%%%%%%%%%%%%%%%%%%%%%%%%%%%%
